............................King Kong – Haikaiss
Wap – Cardi B Feat. Megan Thee Stallion
Vou Ter Que Tomar Uma – Zezé Di Camargo
Assim Nasce Um Bêbado – Luan Santana
Ficante Fiel – Mad Dogz Feat. Mari Fernandez
Jeito Matuto – Edy e Nathan Feat. Rai Saia Rodada
Sigilinho – Psirico Feat. Os Barões da Pisadinha
Plágio – May e Karen Feat. Marcos e Belutti
Gostosa Posturada – Slipmami
Infinito – ALMAR Feat. 3030
A Gente Combina – Ana Vilela
Arranhão – Henrique e Juliano
Tapinha No Bumbum – MC Danny, Felipe Original e Mayk Pancadão
Acústico Luazul #2: Deixa a Vida Levar – Belle Kaffer, Casluh, Hyperanhas Feat. MC Vinny e DaPaz
190 – Tiee
Estado Frágil – Marcos e Belutti Feat. Dilsinho
Doida – Renno Feat. Mano Walter e Matheus Fernandes
Faxina – Guilherme e Benuto Feat. Os Barões da Pisadinha
Fatalidades do Mundo – MC Leozinho ZS, MC Magal, MC Cebezinho, MC Cassiano, MC Kako, MC NathanZK e MC King
Sagitariana – Menor MC
War – Filipe Ret
Mudei Demais – Hugo e Vitor
Zero Um – Vulgo FK, MC Marks e MC Davi Feat. Tropkillaz
Simplesmente Sobrenatural – Paulo Neto
Alive (It Feels Like) – Alok
Você Beberia ou Não Beberia? – Zé Neto e Cristiano
Mina de Fé – MC Kevin
Minha Pequena – Léo Magalhães
Let’s Love – David Guetta Feat. Sia
Bloquear no TikTok – Railan Soares
Amor ou Razão – Antonio Moraes
Facas – Diego e Victor Hugo Feat. Bruno e Marrone
O Famoso Tanto Faz – Walber Feat. Mc Don Juan e Dj Lucas Beat
Bandido Mau – FP do Trem Bala Feat. MC Scar
Goes Around – Jetlag, Santti e Jay Jenner
Dias de Guerra – Valesca Mayssa e Stella Laura
Combate de Bumbum – GKAY Feat. ISRAELL MUNIZ
Fuga Planejada – Théo e Thiago
Baby Me Atende – Matheus Fernandes e Dilsinho
Ficha Limpa – Gusttavo Lima
Faça O Bem – Anna Mel, Carlinhos Brown
Ela É Malandra – MC Luan Da BS, MC AK, MC Kaio, MC Vaguin
Sem Sentimento – DG e Batidão Stronda, Felipe Amorim Feat. MC Danny
Não Tá Nem Aí pra Nada – MC L da Vinte Feat. MC Kaio e MC Rick
Cangote – Zé Vaqueiro
Soldado Ferido – Midian Lima e Bruna Karla
Passar de Foguetão – MC Don Juan, MC Kevin e MC Ryan SP
Intere$$eira – Luísa Sonza
Bloqueio de Tela – Jecy
Avião – Dani Alves, Fábio JR, Rodrigo Faro, Afonso Nigro
O Tempo Não Espera Ninguém – Michel Teló
Set 3 Dias Virados – MC IG Feat. MC Pedrinho, MC Ryan SP, MC PH, MC Menor da VG, MC GP, MC Lele JP, MC Nego Micha, Aires085, MC Kadu e MC Luki
Troca – Jorge e Mateus
Beijou Meia Cidade – Zé Neto e Cristiano
Party On My Own – Alok, Vintage Culture
Set DJ Victor 3.0 – MC’s PP da Vs Feat. Ruzika, Ryan Sp, Kadu, Menor da Vg e Davi
Beijo do Vampiro – Os Barões da Pisadinha Feat. Wesley Safadão
Bota – MC Baby Perigosa
Me Jogar na Revoada – Lucca e Mateus
Contato de Motel – Ricardo Senna e Diego
Volta Comigo bb – Zé Vaqueiro
Ela e Ela – Zé Neto e Cristiano
Coração Na Cama – Hugo e Guilherme
Rockstar – Junior Lord Feat. MC Kekel e Gaab
A Culpa é do Papato – Papatinho Feat. L7NNON, Orochi e Luccas Carlos
Era Deus – Leandro Borges Feat. Sarah Beatriz
Falling For You – Carola Feat. Briana
Sem Distração – José Wellington
Vencer Adorando – Maurizélia
Clone – Pedro Sanchez e Thiago Feat. Jads e Jadson
Volta Bebê, Volta Neném – DJ Guuga Feat. DJ Ivis
Pelo Sangue – Marcelo Dias e Fabiana Feat. Clayton Queiroz
O Psicopata – Kamaitachi
Esquema Preferido – Os Barões da Pisadinha
Ser Solteiro é Foda – DJ Lucas Beat Feat. Pedro Paulo e Alex
Melhor Dia V – Inesquecível – MC Kevin Feat. MC IG, MC PH, KayBlack, Vulgo FK, Aires 085 e MC Pedrinho
Meu Bem – João Gomes
Baila Mais 2 – Orgânico, Mikezin, Olívia, SóCIRO, Tati Zaqui. Pelé Milflows
Yeshua + Medley Espontâneo – Julliany Souza
Faz Amor Comigo Só Hoje – Israel e Rodolffo Feat. Wesley Safadão
You – Regard Feat. Troye Sivan e Tate McRae
Proposta Indecente – Léo Chaves
Hackearam-me – Tierry part. Marília Mendonça
Parabellum – Dalsin
Porre – Dilsinho
We Can Come Together – Love Regenerator Feat. Calvin Harris e Eli Brown
Vou Falar Que Não Quero – Vitor Fernandes
Dó de Perereca – DJ Kévin Feat. Ericlis Caron
Alvejante – Priscila Senna Feat. Zé Vaqueiro
Esquema Preferido – Dj Ivis
O Carpinteiro – Nattan Feat. Elias Monkbel
Por um Minuto – Yuri Lins
Rasante – Mc Lemos Feat. MC Cebezinho, MC Vinny, MC Fe Castro, MC Nego Blue, MC Piedro e Neguinho do Kaxeta
Uni Duni Tê – WC no Beat Feat. Kawe e PK
Do Crime ao Funk – Bielzin, MC Poze do Rodo e Mãolee
Não Te Quero Mais – Ruivinha De Marte
No Llores Más – Simone e Simaria Feat. Sebastián Yatra
Balança – Mc Jacaré
Chorei no Cabaré – Tierry
